Conteúdo do README.md:
# Projeto go-demo-filtros-curtos

O objeto desse projeto é explorarmos um código para geração de chaves para busca de filtros combinados para uma loja de aplicativos de terminais POS.

Hoje temos como desafio de não expormos a PK das entidades e ao mesmo tempo evitar chaves com nomes muito longos tendo risco de quebra de consultas com muitas junções de filtros.

O aplicativo espera que tenhamos filtros configuráveis para buscas de aplicativos, como por exemplo: região, ramo, subramo, funcionalidades e etc. O filtro pode ser autorelacionado, ou seja, um filtro pode ter subfiltros. Exemplo podemos ter o ramo alimentação e dentro dele termos relacionados subramos como lanchonete, restaurante, bar e etc. Os tipos de filtros e filtros devem corresponder a essa hierarquia.

A deia é que a chave de busca seja composta de ate 3 caracteres cada parte, onde teremos no minimo a combinacao de 2 partes: TipoFiltro + Filtro + (opcional) Subfiltro. Essa chave "curta" deve ser calculada a partir do nome original do filtro, de forma que seja unica e reproduzivel, no caso de colisao, devemos ter uma estrategia para gerar chaves diferentes. Tomar cuidado com carecteres especiais, acentos e etc. Vamos padronizar sempre em maiusculas e sem acentos no formato TTT-FFF-SSS-SSS onde TTT é o tipo do filtro, FFF o filtro e SSSS o subfiltro (opcional).





--- LOG DE nomesCurtos ---

Tipo-filtro: Região
RGO-CNE --> Região-Centro-Oeste (modo=(unknown))
RGO-NRE --> Região-Nordeste (modo=(unknown))
RGO-NTE --> Região-Norte (modo=(unknown))
RGO-SSE --> Região-Sudeste (modo=(unknown))
RGO-SUL --> Região-Sul (modo=(unknown))

Tipo-filtro: Ramo
RMO-AGO --> Ramo-Agronegócio (modo=(unknown))
RMO-ALO --> Ramo-Alimentação (modo=(unknown))
RMO-ATO --> Ramo-Automotivo (modo=(unknown))
RMO-BLA --> Ramo-Beleza (modo=(unknown))
RMO-CNO --> Ramo-Construção (modo=(unknown))
RMO-CSA --> Ramo-Consultoria (modo=(unknown))
RMO-EDO --> Ramo-Educação (modo=(unknown))
RMO-ELS --> Ramo-Eletrodomésticos (modo=(unknown))
RMO-ETS --> Ramo-Eletrônicos (modo=(unknown))
RMO-ENO --> Ramo-Entretenimento (modo=(unknown))
RMO-EVS --> Ramo-Eventos (modo=(unknown))
RMO-IMO --> Ramo-Imobiliário (modo=(unknown))
RMO-LGA --> Ramo-Logística (modo=(unknown))
RMO-PTP --> Ramo-Pet Shop (modo=(unknown))
RMO-SDE --> Ramo-Saúde (modo=(unknown))
RMO-SRS --> Ramo-Serviços (modo=(unknown))
RMO-TCA --> Ramo-Tecnologia (modo=(unknown))
RMO-TRE --> Ramo-Transporte (modo=(unknown))
RMO-TRO --> Ramo-Turismo (modo=(unknown))
RMO-VRO --> Ramo-Varejo (modo=(unknown))

Tipo-filtro: Sub-ramos
RMO-IMO-ADS --> Ramo-Imobiliário-Administração de Condomínios (modo=(unknown))
RMO-TRO-AGS --> Ramo-Turismo-Agência de Viagens (modo=(unknown))
RMO-TRE-APE --> Ramo-Transporte-Aplicativo de Mobilidade (modo=(unknown))
RMO-LGA-ARM --> Ramo-Logística-Armazenagem (modo=(unknown))
RMO-CNO-ARA --> Ramo-Construção-Arquitetura (modo=(unknown))
RMO-ELS-ASA --> Ramo-Eletrodomésticos-Assistência Técnica (modo=(unknown))
RMO-ALO-BAR --> Ramo-Alimentação-Bar (modo=(unknown))
RMO-EVS-BFT --> Ramo-Eventos-Buffet (modo=(unknown))
RMO-BLA-CBO --> Ramo-Beleza-Cabeleireiro (modo=(unknown))
RMO-EVS-CRL --> Ramo-Eventos-Cerimonial (modo=(unknown))
RMO-ENO-CNA --> Ramo-Entretenimento-Cinema (modo=(unknown))
RMO-SDE-CLA --> Ramo-Saúde-Clínica Médica (modo=(unknown))
RMO-PTP-CCA --> Ramo-Pet Shop-Clínica Veterinária (modo=(unknown))
RMO-AGO-CMO --> Ramo-Agronegócio-Comercialização (modo=(unknown))
RMO-ETS-CMS --> Ramo-Eletrônicos-Componentes (modo=(unknown))
RMO-CSA-CTA --> Ramo-Consultoria-Consultoria Financeira (modo=(unknown))
RMO-CSA-CJA --> Ramo-Consultoria-Consultoria Jurídica (modo=(unknown))
RMO-CSA-CNH --> Ramo-Consultoria-Consultoria RH (modo=(unknown))
RMO-AGO-CPS --> Ramo-Agronegócio-Cooperativas (modo=(unknown))
RMO-IMO-CRM --> Ramo-Imobiliário-Corretagem (modo=(unknown))
RMO-BLA-CSS --> Ramo-Beleza-Cosméticos (modo=(unknown))
RMO-EDO-CRS --> Ramo-Educação-Cursos Livres (modo=(unknown))
RMO-TCA-DSE --> Ramo-Tecnologia-Desenvolvimento de Software (modo=(unknown))
RMO-EDO-EAD --> Ramo-Educação-EAD (modo=(unknown))
RMO-BLA-ESA --> Ramo-Beleza-Estética (modo=(unknown))
RMO-VRO-FRA --> Ramo-Varejo-Farmácia (modo=(unknown))
RMO-AGO-FZS --> Ramo-Agronegócio-Fazendas (modo=(unknown))
RMO-LGA-FRE --> Ramo-Logística-Frete (modo=(unknown))
RMO-TRO-GSS --> Ramo-Turismo-Guias Turísticos (modo=(unknown))
RMO-TCA-HRE --> Ramo-Tecnologia-Hardware (modo=(unknown))
RMO-TRO-HTA --> Ramo-Turismo-Hotelaria (modo=(unknown))
RMO-EDO-IDS --> Ramo-Educação-Idiomas (modo=(unknown))
RMO-IMO-IMS --> Ramo-Imobiliário-Imobiliárias (modo=(unknown))
RMO-ENO-JGS --> Ramo-Entretenimento-Jogos (modo=(unknown))
RMO-SDE-LBO --> Ramo-Saúde-Laboratório (modo=(unknown))
RMO-ALO-LNE --> Ramo-Alimentação-Lanchonete (modo=(unknown))
RMO-SRS-LVA --> Ramo-Serviços-Lavanderia (modo=(unknown))
RMO-ELS-LJS --> Ramo-Eletrodomésticos-Loja de Eletrodomésticos (modo=(unknown))
RMO-ETS-LLS --> Ramo-Eletrônicos-Loja de Eletrônicos (modo=(unknown))
RMO-VRO-LRS --> Ramo-Varejo-Loja de Roupas (modo=(unknown))
RMO-CNO-MTO --> Ramo-Construção-Materiais de Construção (modo=(unknown))
RMO-AGO-MQS --> Ramo-Agronegócio-Máquinas Agrícolas (modo=(unknown))
RMO-SDE-ODA --> Ramo-Saúde-Odontologia (modo=(unknown))
RMO-SRS-OFA --> Ramo-Serviços-Oficina (modo=(unknown))
RMO-EVS-ORS --> Ramo-Eventos-Organização de Eventos (modo=(unknown))
RMO-ALO-PDA --> Ramo-Alimentação-Padaria (modo=(unknown))
RMO-TRO-PSS --> Ramo-Turismo-Passeios (modo=(unknown))
RMO-ATO-PCS --> Ramo-Automotivo-Peças e Acessórios (modo=(unknown))
RMO-PTP-PRS --> Ramo-Pet Shop-Produtos para Animais (modo=(unknown))
RMO-EDO-PRR --> Ramo-Educação-Pré-vestibular (modo=(unknown))
RMO-CNO-RFS --> Ramo-Construção-Reformas (modo=(unknown))
RMO-ALO-RSE --> Ramo-Alimentação-Restaurante (modo=(unknown))
RMO-ATO-RVS --> Ramo-Automotivo-Revendas (modo=(unknown))
RMO-SRS-SLA --> Ramo-Serviços-Salão de Beleza (modo=(unknown))
RMO-CNO-SVS --> Ramo-Construção-Serviços de Obras (modo=(unknown))
RMO-ENO-SHS --> Ramo-Entretenimento-Shows (modo=(unknown))
RMO-VRO-SPO --> Ramo-Varejo-Supermercado (modo=(unknown))
RMO-TCA-SRO --> Ramo-Tecnologia-Suporte Técnico (modo=(unknown))
RMO-TCA-TCO --> Ramo-Tecnologia-TI Corporativo (modo=(unknown))
RMO-ENO-TTO --> Ramo-Entretenimento-Teatro (modo=(unknown))
RMO-LGA-TRS --> Ramo-Logística-Transporte de Cargas (modo=(unknown))
RMO-TRE-TXI --> Ramo-Transporte-Táxi (modo=(unknown))
RMO-TRE-ONS --> Ramo-Transporte-Ônibus (modo=(unknown))

Tipo-filtro: Funcionalidade
FNE-GSE --> Funcionalidade-Gestão de Estoque (modo=(unknown))
FNE-INP --> Funcionalidade-Integração com ERP (modo=(unknown))
FNE-PGC --> Funcionalidade-Pagamento por NFC (modo=(unknown))
FNE-PRE --> Funcionalidade-Programa de Fidelidade (modo=(unknown))
FNE-RLS --> Funcionalidade-Relatórios de Vendas (modo=(unknown))

Tipo-filtro: Estado
RGO-NTE-ACE --> Região-Norte-Acre (modo=(unknown))
RGO-NRE-ALS --> Região-Nordeste-Alagoas (modo=(unknown))
RGO-NTE-AMA --> Região-Norte-Amapá (modo=(unknown))
RGO-NTE-AMS --> Região-Norte-Amazonas (modo=(unknown))
RGO-NRE-BHA --> Região-Nordeste-Bahia (modo=(unknown))
RGO-NRE-CRA --> Região-Nordeste-Ceará (modo=(unknown))
RGO-CNE-DSL --> Região-Centro-Oeste-Distrito Federal (modo=(unknown))
RGO-SSE-ESO --> Região-Sudeste-Espírito Santo (modo=(unknown))
RGO-CNE-GOS --> Região-Centro-Oeste-Goiás (modo=(unknown))
RGO-NRE-MRO --> Região-Nordeste-Maranhão (modo=(unknown))
RGO-CNE-MGO --> Região-Centro-Oeste-Mato Grosso (modo=(unknown))
RGO-CNE-MTL --> Região-Centro-Oeste-Mato Grosso do Sul (modo=(unknown))
RGO-SSE-MNS --> Região-Sudeste-Minas Gerais (modo=(unknown))
RGO-SUL-PRA --> Região-Sul-Paraná (modo=(unknown))
RGO-NRE-PBA --> Região-Nordeste-Paraíba (modo=(unknown))
RGO-NTE-PAA --> Região-Norte-Pará (modo=(unknown))
RGO-NRE-PRO --> Região-Nordeste-Pernambuco (modo=(unknown))
RGO-NRE-PII --> Região-Nordeste-Piauí (modo=(unknown))
RGO-NRE-RGE --> Região-Nordeste-Rio Grande do Norte (modo=(unknown))
RGO-SUL-RGL --> Região-Sul-Rio Grande do Sul (modo=(unknown))
RGO-SSE-RJO --> Região-Sudeste-Rio de Janeiro (modo=(unknown))
RGO-NTE-RNA --> Região-Norte-Rondônia (modo=(unknown))
RGO-NTE-RRA --> Região-Norte-Roraima (modo=(unknown))
RGO-SUL-SNA --> Região-Sul-Santa Catarina (modo=(unknown))
RGO-NRE-SRE --> Região-Nordeste-Sergipe (modo=(unknown))
RGO-SSE-SLO --> Região-Sudeste-São Paulo (modo=(unknown))
RGO-NTE-TCS --> Região-Norte-Tocantins (modo=(unknown))
