Conteúdo do README.md:
# Projeto go-demo-filtros-curtos

O objeto desse projeto é explorarmos um código para geração de chaves para busca de filtros combinados para uma loja de aplicativos de terminais POS.

Hoje temos como desafio de não expormos a PK das entidades e ao mesmo tempo evitar chaves com nomes muito longos tendo risco de quebra de consultas com muitas junções de filtros.

O aplicativo espera que tenhamos filtros configuráveis para buscas de aplicativos, como por exemplo: região, ramo, subramo, funcionalidades e etc. O filtro pode ser autorelacionado, ou seja, um filtro pode ter subfiltros. Exemplo podemos ter o ramo alimentação e dentro dele termos relacionados subramos como lanchonete, restaurante, bar e etc. Os tipos de filtros e filtros devem corresponder a essa hierarquia.

A deia é que a chave de busca seja composta de ate 3 caracteres cada parte, onde teremos no minimo a combinacao de 2 partes: TipoFiltro + Filtro + (opcional) Subfiltro. Essa chave "curta" deve ser calculada a partir do nome original do filtro, de forma que seja unica e reproduzivel, no caso de colisao, devemos ter uma estrategia para gerar chaves diferentes. Tomar cuidado com carecteres especiais, acentos e etc. Vamos padronizar sempre em maiusculas e sem acentos no formato TTT-FFF-SSS-SSS onde TTT é o tipo do filtro, FFF o filtro e SSSS o subfiltro (opcional).





--- LOG DE nomesCurtos ---

Tipo-filtro: Sub-ramos
RMO-IMO-ADS --> Ramo-Imobiliário-Administração de Condomínios
RMO-TRO-AGS --> Ramo-Turismo-Agência de Viagens
RMO-TRE-APE --> Ramo-Transporte-Aplicativo de Mobilidade
RMO-LGA-ARM --> Ramo-Logística-Armazenagem
RMO-CNO-ARA --> Ramo-Construção-Arquitetura
RMO-ELS-ASA --> Ramo-Eletrodomésticos-Assistência Técnica
RMO-ALO-BAR --> Ramo-Alimentação-Bar
RMO-EVS-BFT --> Ramo-Eventos-Buffet
-CBO --> Beleza-Cabeleireiro
RMO-EVS-CRL --> Ramo-Eventos-Cerimonial
RMO-ENO-CNA --> Ramo-Entretenimento-Cinema
RMO-SDE-CLA --> Ramo-Saúde-Clínica Médica
RMO-PTP-CCA --> Ramo-Pet Shop-Clínica Veterinária
RMO-AGO-CMO --> Ramo-Agronegócio-Comercialização
RMO-ETS-CMS --> Ramo-Eletrônicos-Componentes
RMO-CSA-CTA --> Ramo-Consultoria-Consultoria Financeira
RMO-CSA-CJA --> Ramo-Consultoria-Consultoria Jurídica
RMO-CSA-CNH --> Ramo-Consultoria-Consultoria RH
RMO-AGO-CPS --> Ramo-Agronegócio-Cooperativas
RMO-IMO-CRM --> Ramo-Imobiliário-Corretagem
BLA-CSS --> Beleza-Cosméticos
RMO-EDO-CRS --> Ramo-Educação-Cursos Livres
RMO-TCA-DSE --> Ramo-Tecnologia-Desenvolvimento de Software
RMO-EDO-EAD --> Ramo-Educação-EAD
BLA-ESA --> Beleza-Estética
RMO-VRO-FRA --> Ramo-Varejo-Farmácia
RMO-AGO-FZS --> Ramo-Agronegócio-Fazendas
RMO-LGA-FRE --> Ramo-Logística-Frete
RMO-TRO-GSS --> Ramo-Turismo-Guias Turísticos
RMO-TCA-HRE --> Ramo-Tecnologia-Hardware
RMO-TRO-HTA --> Ramo-Turismo-Hotelaria
RMO-EDO-IDS --> Ramo-Educação-Idiomas
RMO-IMO-IMS --> Ramo-Imobiliário-Imobiliárias
RMO-ENO-JGS --> Ramo-Entretenimento-Jogos
RMO-SDE-LBO --> Ramo-Saúde-Laboratório
RMO-ALO-LNE --> Ramo-Alimentação-Lanchonete
RMO-SRS-LVA --> Ramo-Serviços-Lavanderia
RMO-ELS-LJS --> Ramo-Eletrodomésticos-Loja de Eletrodomésticos
RMO-ETS-LLS --> Ramo-Eletrônicos-Loja de Eletrônicos
RMO-VRO-LRS --> Ramo-Varejo-Loja de Roupas
RMO-CNO-MTO --> Ramo-Construção-Materiais de Construção
RMO-AGO-MQS --> Ramo-Agronegócio-Máquinas Agrícolas
RMO-SDE-ODA --> Ramo-Saúde-Odontologia
RMO-SRS-OFA --> Ramo-Serviços-Oficina
RMO-EVS-ORS --> Ramo-Eventos-Organização de Eventos
RMO-ALO-PDA --> Ramo-Alimentação-Padaria
RMO-TRO-PSS --> Ramo-Turismo-Passeios
RMO-ATO-PCS --> Ramo-Automotivo-Peças e Acessórios
RMO-PTP-PRS --> Ramo-Pet Shop-Produtos para Animais
RMO-EDO-PRR --> Ramo-Educação-Pré-vestibular
RMO-CNO-RFS --> Ramo-Construção-Reformas
RMO-ALO-RSE --> Ramo-Alimentação-Restaurante
RMO-ATO-RVS --> Ramo-Automotivo-Revendas
RMO-SRS-SLA --> Ramo-Serviços-Salão de Beleza
RMO-CNO-SVS --> Ramo-Construção-Serviços de Obras
RMO-ENO-SHS --> Ramo-Entretenimento-Shows
RMO-VRO-SPO --> Ramo-Varejo-Supermercado
RMO-TCA-SRO --> Ramo-Tecnologia-Suporte Técnico
RMO-TCA-TCO --> Ramo-Tecnologia-TI Corporativo
RMO-ENO-TTO --> Ramo-Entretenimento-Teatro
RMO-LGA-TRS --> Ramo-Logística-Transporte de Cargas
RMO-TRE-TXI --> Ramo-Transporte-Táxi
RMO-TRE-ONS --> Ramo-Transporte-Ônibus

Tipo-filtro: Funcionalidade
FNE-GSE --> Funcionalidade-Gestão de Estoque
FNE-INP --> Funcionalidade-Integração com ERP
FNE-PGC --> Funcionalidade-Pagamento por NFC
FNE-PRE --> Funcionalidade-Programa de Fidelidade
FNE-RLS --> Funcionalidade-Relatórios de Vendas

Tipo-filtro: Estado
RGO-NTE-ACE --> Região-Norte-Acre
RGO-NRE-ALS --> Região-Nordeste-Alagoas
RGO-NTE-AMA --> Região-Norte-Amapá
RGO-NTE-AMS --> Região-Norte-Amazonas
RGO-NRE-BHA --> Região-Nordeste-Bahia
RGO-NRE-CRA --> Região-Nordeste-Ceará
RGO-CNE-DSL --> Região-Centro-Oeste-Distrito Federal
RGO-SSE-ESO --> Região-Sudeste-Espírito Santo
RGO-CNE-GOS --> Região-Centro-Oeste-Goiás
RGO-NRE-MRO --> Região-Nordeste-Maranhão
RGO-CNE-MGO --> Região-Centro-Oeste-Mato Grosso
RGO-CNE-MTL --> Região-Centro-Oeste-Mato Grosso do Sul
RGO-SSE-MNS --> Região-Sudeste-Minas Gerais
RGO-SUL-PRA --> Região-Sul-Paraná
RGO-NRE-PBA --> Região-Nordeste-Paraíba
RGO-NTE-PAA --> Região-Norte-Pará
RGO-NRE-PRO --> Região-Nordeste-Pernambuco
RGO-NRE-PII --> Região-Nordeste-Piauí
RGO-NRE-RGE --> Região-Nordeste-Rio Grande do Norte
RGO-SUL-RGL --> Região-Sul-Rio Grande do Sul
RGO-SSE-RJO --> Região-Sudeste-Rio de Janeiro
RGO-NTE-RNA --> Região-Norte-Rondônia
RGO-NTE-RRA --> Região-Norte-Roraima
RGO-SUL-SNA --> Região-Sul-Santa Catarina
RGO-NRE-SRE --> Região-Nordeste-Sergipe
RGO-SSE-SLO --> Região-Sudeste-São Paulo
RGO-NTE-TCS --> Região-Norte-Tocantins

Tipo-filtro: Região
RGO-CNE --> Região-Centro-Oeste
RGO-NRE --> Região-Nordeste
RGO-NTE --> Região-Norte
RGO-SSE --> Região-Sudeste
RGO-SUL --> Região-Sul

Tipo-filtro: Ramo
RMO-AGO --> Ramo-Agronegócio
RMO-ALO --> Ramo-Alimentação
RMO-ATO --> Ramo-Automotivo
RMO-CNO --> Ramo-Construção
RMO-CSA --> Ramo-Consultoria
RMO-EDO --> Ramo-Educação
RMO-ELS --> Ramo-Eletrodomésticos
RMO-ETS --> Ramo-Eletrônicos
RMO-ENO --> Ramo-Entretenimento
RMO-EVS --> Ramo-Eventos
RMO-IMO --> Ramo-Imobiliário
RMO-LGA --> Ramo-Logística
RMO-PTP --> Ramo-Pet Shop
RMO-SDE --> Ramo-Saúde
RMO-SRS --> Ramo-Serviços
RMO-TCA --> Ramo-Tecnologia
RMO-TRE --> Ramo-Transporte
RMO-TRO --> Ramo-Turismo
RMO-VRO --> Ramo-Varejo
